1111111111111
10E1000000001
1000011111001
10P0110001001
1111111111111
