1111111111111
10E1000000001
10C0011111001
10P011P001001
1111111111111
