1111111111111
10E1000000001
10C00111110001
10P0110001001
1111111111111
