1111111111111111111111111111111111
1E101C00000000000000C1C1C010000001
1010011100100000101001010000011101
1C1C010001100C00101001010010000C01
1010010100100000101001001000011111
1P000000001000C00010000000C10000C1
1111111111111111111111111111111111
