11111111
1CE00001
1P000001
11111111
