1111111111111111111
10001000000001000C1
1010011100100100101
1110010001100000101
1010010100100C00101
1P00000E00100000001
1111111111111111111
